%%%%%%%%%%%%%%%%%%%%%%%%%%%%%%%%%%%%%
%   %   %   %   %   %   %   %   %   %  
% %   %   %   %   %   %   %   %   % %
%   %   %   %   %   %   %   %   %   %  
% %   %   %   %   %   %   %   %   % %
%   %   %   %   %   %   %   %   %   %  
% %   %   %   %   %   %   %   %   % %  
% %   %   %   %   %   %   %   %   % %
%   %   %   %   %   %   %   %   %   %  
% %   %   %   %   %   %   %   %   % %
%   %   %   %   %   %   %   %   %   %  
% %   %   %   %   %   %   %   %   % %
%   %   %   %   %   %   %   %   %   %  
% %   %   %   %   %   %   %   %   % %
%   %   %   %   %   %   % P %   %   %  
% %   %   %   %   %   %   %   %   % %
%   %   %   %   %   %   %   %   %   %  
% %   %   %   %   %   %   %   %   % %
%   %   %   %   %   %   %   %   %   %  
% %   %   %   %   %   %   %   %   % %
%   %   %   %   %   %   %   %   %   %  
% %   %   %   %   %   %   %   %   % %
%   %   %   %   %   %   %   %   %   %  
%.%   %   %   %   %   %   %   %     %
%%%%%%%%%%%%%%%%%%%%%%%%%%%%%%%%%%%%%