%%%%%%%%%%%%%%%%%%%%%%%%%
%P                      %
% %%% %%% %% %%  % %%%% %
%%%        %  % %%    % %
% % %%%%%%%%% % %  % %% %
% %%% % % % % % %%%% %  %
%     % % % % % %    %  %
% %%%%%   %       %% %% %
% % %   %%%%%%%% %%     %
% % %%%       %   %%%%% %
%   % % % %%% % %%%   % %
% %%% % %   % % %   % % %
% %   % % % % %   %%%   %
% % % % % % % % % % %%% %
%   %   % %   % % %     %
% % % %   % % % %   %%% %
% %%%%% %%% %%% %%%%% % %
%.    %                 %
%%%%%%%%%%%%%%%%%%%%%%%%%