%%%%%%%%%%%%%%%%%%%%%%%%%%%%%%%%%%%%%
% %%%  %%%%%%%%% %%% %%%%%%% %    %P%
%   %%%%       % % %       % % %% % %
%%% % % %%% %% % % % % % %%       % %
% % % % %%% %% % % % % %   % %% %%% %
% % % %            % %%% %%%  %     %
% % % % %%%%%%%%%% %       % %  %%% %
% % % %% %%%     % % %% %%%% %%     %
% % % %%        %% % %% %     % % % %
% % % %% %%%%%%%%% % %%%%%%% %  % % %
% % % %% %                    % % % %
% % % %% %%%%%%% % % % %%%%% %  % % %
% %          % % %%% %     %  % %% %%
% % %%%%%%% %% %    %% %% %% %%     %
% % %   %    % % % % % %% %% %% % % %
%%% %%%%% % %% %%% % %%%%%%%%%% % % %
%         %%                    % % %
% %%%% %% %%%%%%%%%%%%%% %%%% % % % %
% %%%%  % %          %%% %% % % %   %
%%      % %% %% %% % % % %  % % % % %
%%% %%  % %%    %  % % %%%% % % % % %
%%% %% %% %%%%% %% %      %%%%%%% % %
%.  % %%        %  % % %%           %
%%%%%%%%%%%%%%%%%%%%%%%%%%%%%%%%%%%%%