%%%%%%%%%%%%%%%%%%%%%%%%%%%%%%%%%%%%%
%.  %   %     %   %     %   %     % %
% %   %   % % % %   % %   %   % %   %
%% % %%%% %%  %%% % %% % %%%% %% % %%
%  %  % %%%  %% % %%%  %  % %%%  %  %
% %%%%%   % %%%%%   % %%%%%   % %% %%
% %% %  %%% %%    %%% %% %  %%% %%  %
%    %  %   %% %%     %             %
% %   %   % %   %   % %   %   % %   %
%% % %%%% %% % %%%% %% % %%%% %% % %%
%     % % %     % %%%     % %%%  %  %
% %%%     % %%%%%   % %%%%%   % %%%%%
% %% %  %%  %%    %%% %%    %%% %%  %
%   %%%%%  %%%%%%%%             %   %
% %   %   % %   % % % %   %   %     %
%% % %%%% %% % %%%% %% % %%%% %%%%% %
%  %  % % %  %  % %%%  %  % %%%  %  %
% %% %%   % %%%%%   % %%%%%   %  %  %
% %%    %%% %%    %%% %%    %%%    P%
%%%%%%%%%%%%%%%%%%%%%%%%%%%%%%%%%%%%%