%%%%%%%%%%%%%%%%%%%
%  % % %          %
%    % % %%%%%% % %
% %% %%%        % %
%  %   %% %%%%% % %
%% %%% %% %   %   %
%  %   %% % % % % %
%% %%% %% % % % % %
%    %      % % % %
%% % %% % % % % % %
%%%% %% %%% %   % %
%% % %%%%   %%%%%%%
%.   %    %      P%
%%%%%%%%%%%%%%%%%%%