%%%%%%%%%%%%%%%%%%%%%%%%%
%                      P%
% %%% %%% %% %%  % %%%% %
%%%        %  % %%    % %
% % %%%%%% %% % %  % %% %
% %%% % %   % % %%%% %  %
%     % % % % % %    %  %
% %%%%%   %       %% %% %
% % %   %%% %%%% %%     %
% % %%%           %%%%% %
%   % % % %%% % %%%   % %
% %%% % %   % % %   % % %
% %   % % % % %   %%%   %
% % % % % % % % % % %%% %
%   %   % %   % % %     %
% % % %   % % % %   %%% %
% %%%%% %%% %%% %%%%% % %
%.    %                 %
%%%%%%%%%%%%%%%%%%%%%%%%%