%%%%%%%%%%%%%%%%%%%%%%%%%%%%%%%%%%%%%
% %%%  %%%%%%%%% %%% %%%%%%% %    %P%
%   %%%        % % %       % % %% % %
%%% % % %%% %% % % % % %%%        % %
% % % % %%% %% % % % % %   % %% %%% %
% % % %            % %%% %%%  %     %
% % % % %%%%%%%%%% %       % %  %%% %
% % % %  %%%     % % %% %%%% %%     %
% % % %%        %% % %%       % % % %
% % % %% %%%%%%%%% % %%%%%%% %  % % %
% % % %%                     %  % % %
% % % %% %%%%%%%%% % % %%%%% %  % % %
% %              %%% %     %  % %% %%
% % %%%%%%% %% %     % %% %% %%     %
% % %   %    % % % % % %% %% %% % % %
%%% %%%%% % %% %%% % %%%%%%%%%% % % %
%         %%                    % % %
% %%%%% % %%%%%%%%%%%%%% %%%% % % % %
% %%%%  % %          %%% %% % % %   %
%%      % %% %% %% % % % %  % % % % %
%%% %%  % %%    %  % % %%%% % % % % %
%%% %% %% %%%%% %% %      %%%%%%% % %
%.  % %%        %  % % %%           %
%%%%%%%%%%%%%%%%%%%%%%%%%%%%%%%%%%%%%