%%%%%%%%%%%%%%%%%%%%%%%%%%%%%%%%%%%%%
%   %   %     %   %     %   %     % %
% %   %   % % % %   % %   %   % %   %
%% % %%%% %%  %%% % %% % %%%% %% % %%
%  %  % %%%  %% % %%%  %  % %%%  %  %
% %%%%%   % %%%%%   % %%%%%   % %% %%
% %% %  %%% %%    %%% %% %  %%% %%  %
%    %  %   %% %%     %             %
% %   %   % %   %   % %   %   % %   %
%% % %%%% %% % %%%% %% % %%%% %% % %%
%     % % %     % %%%     % %%%  %  %
% %%%     % %%%%%   % %%%%%   % %%%%%
% %% %  %   %%    %%% %%    %%% %%  %
%   %%%%%  %%%%%%%%             %   %
%  %  %   % %   % % % %   %   %     %
%% % %%%% %% % %%%% %% % %%%% %%%%% %
%  %  % % %  %  % %%%  %  % %%%  %  %
% %% %%   % %%%%%   % %%%%%   %  %  %
%.    %       %                    P%
%%%%%%%%%%%%%%%%%%%%%%%%%%%%%%%%%%%%%