%%%%%%%%%%%%%%%%%%%%%%%%%
%                      P%
%%%% %%%   % %%% % %%%% %
%  % % % %%% %   % %    %
%  % % %   % %% %% % %% %
% %% % % %%%  % %     % %
% %    %        % % %%% %
% %%%%   %%% %    % %   %
%    % %     % %%       %
% %% % %%%%% %  % %%%%% %
% %      %   %% % %     %
% % %%%% % %    % % %%% %
% %    % % %%%%       % %
% %  % %   %    %%%%% % %
% %% % %%% %%%% %  %  % %
%    %      % % %% %    %
% %%%%%%% %%% %  % % %%%%
%.%                %    %
%%%%%%%%%%%%%%%%%%%%%%%%%