%%%%%%%%%%%%%%%%%%%%
%  %  % %  %   % % %
% %% %% %% % %%% % %
%     %       %% % %
%%% % %% %% %      %
%   %  %    % %%% %%    
% % %%   %% % % %%%%
% %%%% % %%%% %    %
% %    % %      %%%%
% %%%% %%% %%%%    %
%  %     % %%%%% % %
%% % %%% % %     % %
%. %   % % %%%%% %P%
%%%%%%%%%%%%%%%%%%%%
