%%%%%%%%%%%%%%%%%
%.%   %  %      %
% % % % %% % %% %
% % % % %% %%%  %
%   % %         %
%%%%% % % %%%%% %
%     %%% %     %
% %%%%% % %%% % %
%   %     %   % %
% %%% %%%%% %%% %
%         %     %
%%%%%% %%%%% %%%%
%      %       P%
%%%%%%%%%%%%%%%%%
