%%%%%%%%%%%%%%%%%%%%%%%%%
%                       %
% %% % % % %%%%%%%%%%%% %
%  % % % %            % %
%  % % % %%%%% %%%%     %
%  % % %          % %%%%%
% %% % % %%%% %%% % %   %
%      % %    %   % % % %
% %%%% % % % %% % % % % %
%          %  %%%     % %
% %% %%% % %       %%%% %
% %%     % % % % %      %
% %% % % %%% % % % %%%%%%
%    % % % % % % %  %   %
% %% % % % % % % %  % % %
%    % %     %   % %% % %
% %%%% % %%% %%% % %% % %
%.%              %    %P%
%%%%%%%%%%%%%%%%%%%%%%%%%