%%%%%%%%%%%%%%%%%
% %   %  %      %
% % % % %% % %% %
% % % % %% %%%  %
%   % %         %
%%%%% % % %%%%% %
%     %%% %     %
% %%%%% % %%% % %
%   %     %   % %
% %%% %%%%% %%% %
%         %     %
%% %%% %%%%% %%%%
%.    %        P%
%%%%%%%%%%%%%%%%%
