%%%%%%%%%%%%%%%%%%%%%%%%%
%.                      %
% %%% %%% %% %%  % %%%% %
% %        %  % %%    % %
% % % %%%% %% % %  % %% %
% %%% % %   % % %%%% %  %
%     % % % % % %    %  %
% %%%%%   %       %% %% %
% % %   %%% %%%% %%     %
% % %%%           %%%%% %
%   % % % %%% % %%%   % %
% %%% % %   % % %   % % %
% %   % % % % %   %%%   %
% % % % % % % % % % %%% %
%   %   % %   % % %     %
% % % %   % % % %   %%% %
% %%%%% %%% %%% %%%%% % %
%                      P%
%%%%%%%%%%%%%%%%%%%%%%%%%