%%%%%%%%%%%%%%%%%%%%%%%%%
%                       %
% %% %%%   % %%% % %%%% %
%  % % % %%% %   % %    %
%  % % %   % %% %% % %% %
% %% % % %%%  % %     % %
%      %        % % %%% %
% %%%%   %%% %    % %   %
%    % %     % %%       %
% %% % %%%%% %  % %%%%% %
% %      %   %% % %     %
% % %%%% % %    % % %%% %
% %    % % %%%%       % %
% %  % %   %    %%%%% % %
% %% % %%% %%%% %  %  % %
%    %      % % %% %    %
% %%%%%%% %%% %  % % %%%%
%.%                %   P%
%%%%%%%%%%%%%%%%%%%%%%%%%