%%%%%%%%%%%%%%%%%%%%%%%%%
%                       %
% %% % % % %%%%%%%%%%%% %
%  % % % %            % %
%  % % % %%%%% %%%%     %
%  % % %          % %%%%%
% %% % % %%%%%%%% % % P %
%      % %    %   % % % %
% %%%% %%% % %% % % % % %
%          %  %%%     % %
% %% %%% % %   %   %%%% %
% %%   % % % % % %      %
% %% % % %%% % % % %%%%%%
%    % % % % % % %  %   %
% %%%% % % % % % %  % % %
%    % %     %   % %% % %
% %%%% % %%% %%% % %% % %
%.%    %         %    % %
%%%%%%%%%%%%%%%%%%%%%%%%%