%%%%%%%%%%%%%%%%%%%%%%%%%%%%%%%%%%%%%
%                                   %
%            %%%%%%%%%%%%%%%%%%     %
%            %                %     %
%            %                 %    %
%            %                  %   %
%            %                   %  %
%            %      %               %
%            %      %               %
%            %      %               %
%            %      %               %
%            %      %               %
%            %      %               %
%P           %      %               %
%%%%%%%%%%%%%%      %%%%%%%%%%%%%%%%%
%            %                      %
%            %                      %
%            %                      %
%                                   %
%                                   %
%                                   %
%.                                  %
%%%%%%%%%%%%%%%%%%%%%%%%%%%%%%%%%%%%%