%%%%%%%%%%%%%%%%%%%%%%%%
%                      %
%     %%%%%%%%         %
%     %                %
%     %                %
%     %                %
%     %      %         %
%     %      %         %
%     %      %         %
%    P%      %         %
%%%%%%%      %%%%%%%%%%%
%     %                %
%     %                %
%     %                %
%.                     %
%%%%%%%%%%%%%%%%%%%%%%%%